11111111111111111111
1C100000000000000001
10100000000000000E01
10100000000000000001
100000000P0000000001
10000000000000000001
10000000000000000001
1000C000000000000001
100100000000000000C1
11111111111111111111
