1111111111111
1000000C001E1
100C000000011
10P0000000001
1111111111111
