1111111111111
1000000C000E1
100C000000001
10P0000000001
1111111111111
